                
NNNNhNNHNHNNNNNN
NNNNhNNHNHNNNNNN
NNNChNNHNHNNNNNN
NNNNhNNNNHNNEEEE
BNNNhNNNNDNNEEEE
pppphpppppppEEEE
SSSShSSSSDSSEEEE
SSSShSSSSHSSEEEE
SSSChSSHSHSSSSSS
ASSShSSHSHSSSSSS
SSSShSSHSHSSSSSS